**************************
*********##########*******
*********#........#*******
*********#........#*******
*********#........#*******
*********##########*******
**************************