*********************
****##########*******
****#........#*******
****#........#*******
****#........#*******
****##########*******
*********************
